10
    + + + + + + + +
    +             +
. . . . . . .     +
. . @ . . . .     +
. . . . . . .     +
. . D . . . .     +
. . . . . . .     +
. . . . . . . + + +
. . . . . . .      
C . . . . . .      

Monster can force a win by going NE (but not N or E)
