10
I . . . . . .      
. . . . . . .      
. . . . . @ .      
. . . . . . . + + +
. . . . . . .     +
. . . . . . . + + +
. . . . . . J      
. . . . . . .      
. . . . . . .      
K . . . . . L      

Rogue can survive indefinitely, but optimal strategy requires
moving toward the monster in the first step.
