10
          + + + + +
          +       +
. . . . . . . .   +
. . . . . . . .   +
. F . . . @ . .   +
. . . . . . . .   +
E . . . . . . .   +
          +       +
          +       +
          + + + + +

Monster's only optimal strategy is E.
