10
. . . . . . . . A .
. . . . . . . . . .
.             . . .
. . . . . . . . . .
. . . . @ . . . . .
. . . . . . . . . .
. . . . . . . . . .
. . . . . . . . . .
. . . . . . . . . .
. . . . . . . . . .

monster can trap player in SW corner after 9th move
